#LEVEL $1$
		000000000000000000000000
		00---0000000000000000000
		000000000000000000000000
		000000---000000000000000
		000000000000---000000000
		000000000000000000000000
		0000000000000000---00000
		000000000000000000000000
#LEVEL $2$
		000000000000000000000000
		000000000000000000000000
		000000000000000000000000
		000000---000000000000000
		0---00000000---000000000
		000000000000000000000000
		0000000---000000---00000
		000000000000000000000000